Certifications O
MP	BDEG
Training	LDEG
Graduated	O
with	O
distinction	UGRD
Top	O
5%	UPERCENT
from	O
U.S.	BINST
Army	IINST
Military	IINST
Police	IINST
School	IINST
USAMPS	LINST
Certifications	O
First	BBRMI
Aid	IBRMI
CPR	LBRMI
Certified	BBRMI
in	IBRMI
Firearms	IBRMI
Safety	LBRMI
